Es ist gut, dass Deutschland viele Flüchtlinge aufgenommen hat.	Politik
Geschäfte sollten jeden Tag rund um die Uhr geöffnet sein.	Wirtschaft
Öffentliche Verkehrsmittel sollten kostenlos sein.	Politik
Deutschland sollte ein Bedingungsloses Grundeinkommen einführen.	Wirtschaft
In der Schule sollte es keine Noten geben.	Bildung
Der Konsum von Cannabis sollte legalisiert werden.	Politik
An Universitäten sollte keine Forschung zu militärischen Zwecken durchgeführt werden.	Bildung
Man sollte schon ab 16 Jahren wählen dürfen.	Politik
Die Türkei sollte in die EU aufgenommen werden.	Politik
Gentechnik ist etwas Gutes.	Umwelt
Es sollte mehr Videoüberwachung im öffentlichen Raum geben.	Politik
Die Erbschaftssteuer sollte erhöht werden.	Wirtschaft
Es ist richtig, dass Hartz-IV-Empfängern ihre Leistungen gekürzt werden, wenn sie ein Job-Angebot ablehnen.	Politik
Homosexuelle Paare sollten Kinder adoptieren dürfen.	Politik
Man lebt besser, wenn man vegan lebt.	Ethik
Der Verfassungsschutz sollte abgeschafft werden.	Politik
Der Euro sollte abgeschafft werden.	Wirtschaft
Es sollte an staatlichen Schulen keinen Religionsunterricht geben.	Bildung
Ausländer sollten an Kommunalwahlen teilnehmen dürfen.	Politik
Die Wehrpflicht sollte wieder eingeführt werden.	Politik
Es wird zu wenig gegen den Klimawandel unternommen.	Umwelt
Die Agenda 2010 war gut für Deutschland.	Wirtschaft
Es sollte eine Steuer auf Plastikverpackungen eingeführt werden.	Umwelt
Kriminelle Ausländer sollten sofort abgeschoben werden.	Politik
Doping im Sport sollte legalisiert werden.	Sport
Deutsche Städte sollten sich für die Ausrichtung von Olympischen Spielen bewerben.	Sport
Es ist besser, Bücher zu lesen statt Filme zu schauen.	Medien
Es ist gut, dass klassische Musik mit Steuergeld gefördert wird.	Medien
Man sollte militärisch gegen den IS vorgehen.	Politik
Kinder sollten früh mit Computern und Smartphones umgehen lernen.	Bildung
